1111111111111
10010CCCCCCC1
1000011111CC1
1P0011ECCCCC1
1111111111111